11111111111111111111111111111
1              0  000000000 1
1                0 00000000 1
1      11     11  0  11   0 1     	    
1      11  0  11  0  11   001
1      0          0     P   1	
100000011     11  0  11   0 1
1      11    011  00 11     1
1      0     0    0  0      1
1      11 0   11  0  11     1
1    0 11     11  0  11     1
1    0    0                 1
1    0 11   0 110000011     1
1      11     11     11     1
1                           1
1  P   11     11     11     1
10    0110000011     11     1
1 000    0 00 0             1
10 00  0   S  0             1
11111111111111111111111111111
